-------------------
-------------------
-------------------
-------------------
---#---------------
----#----------##--
-----#--------#--#-
-#######-----#----#
--------------#--#-
----#-----#----##--
---###---###---##--
--#####-#####-####-