-------------------
-########--------#-
-#------#--------#-
-#------#--------#-
-#---####--------#-
-#---#-----------#-
-#---#----------#--
-#---####-------#--
-#--------------#--
-#-----------------
-#################-
-------------------