-------------------
---##-------#--#---
-----------#-##-#--
----##------#--#---
-------------------
-----##------------
-------------------
----#--------------
-##--#-------------
------#------------
-##--#-------------
----#--------------