-------------------
-------------------
-------------------
-------------------
-------------------
-------------------
--#--#-#---#-#-----
--#--#-##--#-#-----
--####-#-#-#-#-----
--#--#-#--##-#-----
--#--#-#---#-####--
-------------------